@******@@@****X
@****@@@@@@@***
@*************1
*@@@@@@@*******
********@@@@@@@
1***@**********
****@****@*****
****@****@*****
****@****@*****
****@****@*****
********@*****